^ - ^ ^ ^ ^ - -
- ^ - - - ^ - -
^ - - - - - - -
- ^ - - - ^ - -
^ - - - - ^ - -
- ^ ^ ^ ^ - - -
- ^ - - - - - -
^ - - - - - - ^
